11111111111
11P0C0E0111
11111111111