1111111111111
100P000C0E001
1111111111111