1111111111111111
10000C0EP0000011
1111111111111111