11111111111111111111111111111111111111
1000000010000001000C000000000000C00001
1000C0001000C0010000000000000001111111
10000000100000000000000000000000000001
10000000100000000000000100000000000001
100000000000P0000000000100000000E00001
10000000000010000000000100000000000001
10000000000010000000000000000000000001
11111111111111111111111111111111111111